XXXXXXXXXXXXXX
XVVV        EX
XVVV        EX
XVVV        EX
X           EX
X           EX
X      X    EX
XXXXXXXXXXXXXX

Available tiles:
ForwardMoving:0
