XXXXXXXXXXXXXX
XVVV        EX
XVVV      X EX
X           EX
X           EX
X           EX
X      X    EX
XXXXXXXXXXXXXX

Available tiles:
ForwardMoving:0
Dublicating:2
Rotating:3

