XXXXXXXXXXXXXX
XVVV         X
XVVV         X
XVVV         X
X            X
X            X
X      X    EX
XXXXXXXXXXXXXX

Available tiles:
ForwardMoving:0
ForwardMoving:0
ForwardMoving:0
ForwardMoving:0
