XXXXXXXXXXXXXX
XVVVV       EX
XVVVV     X EX
XVVVV       EX
XVVVV       EX
XVVVV       EX
XVVVV  X    EX
XXXXXXXXXXXXXX

Available tiles:
ForwardMoving:0
ForwardMoving:0

#Dublicating:2
#Rotating:3

